0&&&&&&######
&&&&#&&######
&&&#&&&&&&&&&
&&#&&&&&&&&&&
&##&&&&&##&##
&&&&#####&&&0