#&&&&&&######
&&&&#&&######
&&&#&&&&&&&&&
#&#&####&&#&0
&##&&&&&##&##
&&&&###&&&&&&