&&&#&#&&&&&
#&&0#0&&&#&
##&&#&#&&&&
&&&&#&#&#&&
&####&&&&&&
&&&&&&&####
