#& & &&######
&& && #&&####
&&&#&  &&&&&&
#& #&###&&#&0
&##&&&&&##&##
&&&&###&&&&&0