#&&&&&&######
&&&&#&&######
&&&#&&&&&&&&&
&&#&####&&#&0
&##&&&&&##&##
&&&&###&&&&&0