#&&&&&&######
&&&&#&&######
&&&#&&&&&&&&&
#&#&####&&#&0
&##&&&&&##&##
&&&&###&&&&&0