0&&#&&&#0
##&#&#&#&
&&&#&#&#&
&###&#&#&
&###&#&#&
&&&&&#&#&
######&#&
&&&&&&&#&
&#######&
&&&&&&&&&