#&&&&&&######
&&&&#&&##*###
&&&#&&&&&&&&&
#&#&####&&#&0
&##&&&&&##&##
&&&&###&&&&&0